11111111111111111111
10000000000000000I01
100I0000000000000E01
100001C0000011111111
1P0000000000011100C1
11111111111011110111
10000000000000000001
10000000I00000000001
100000000000000000C1
11111111111111111111