111111111111111111111111111
1000000000000000000000000C1
1000I0000000000000000000001
1P0000000000000000I00000001
111111111111110000111111111
100000000000000000000000001
10000C00000000000000000I101
101010000000000000000000101
101E10000000I000000000001C1
111111111111111111111111111