11111111111111111111
1P00000C000000000I01
10I0000000000000E011
11111111111111111111